0 0 0 0 0 0 0 0 0 0 8 4 4 7 0 0 0 0 0 0 0 0 0 0
0 0 0 0 0 0 0 0 0 0 8 4 4 7 0 0 0 0 0 0 0 0 0 0
0 0 0 0 0 0 0 0 0 0 8 4 4 7 0 0 0 0 0 0 0 0 0 0
0 0 0 0 0 0 0 0 0 0 8 4 4 7 0 0 0 0 0 0 0 0 0 0
0 0 0 0 0 0 0 0 0 0 8 4 4 7 0 0 0 0 0 0 0 0 0 0
0 0 0 0 0 0 0 0 0 0 8 4 4 7 0 0 0 0 0 0 0 0 0 0
0 0 0 0 0 0 0 0 0 0 8 4 4 7 0 0 0 0 0 0 0 0 0 0
0 0 0 0 0 0 0 0 0 0 8 4 4 7 0 0 0 0 0 0 0 0 0 0
6 6 6 6 6 6 6 6 6 6 9 4 4 10 6 6 6 6 6 6 6 6 6 6
4 4 4 4 4 4 4 4 4 4 4 4 4 4 4 4 4 4 4 4 4 4 4 4
4 4 4 4 4 4 4 4 4 4 4 4 4 4 4 4 4 4 4 4 4 4 4 4
5 5 5 5 5 5 5 5 5 5 12 4 4 11 5 5 5 5 5 5 5 5 5 5
0 0 0 0 0 0 0 0 0 0 8 4 4 7 0 0 0 0 0 0 0 0 0 0
0 0 0 0 0 0 0 0 0 0 8 4 4 7 0 0 0 0 0 0 0 0 0 0
0 0 0 0 0 0 0 0 0 0 8 4 4 7 0 0 0 0 0 0 0 0 0 0
0 0 0 0 0 0 0 0 0 0 8 4 4 7 0 0 0 0 0 0 0 0 0 0
0 0 0 0 0 0 0 0 0 0 8 4 4 7 0 0 0 0 0 0 0 0 0 0
0 0 0 0 0 0 0 0 0 0 8 4 4 7 0 0 0 0 0 0 0 0 0 0


